111111111111111
11P00111110E111
1111C0101011111
111111111111111
