111111111
1P00E0C01
111111111
